Queue - конструктор
//////////////////////////////////////

Queue()	Инициализирует новый пустой экземпляр класса Queue с заданными по умолчанию исходной емкостью и коэффициентом роста.
	Queue(ICollection) Инициализирует новый экземпляр класса Queue, содержащий элементы, скопированные из указанной 
			коллекции, и обладающий начальной емкостью, равной количеству скопированных элементов, и 
			заданным по умолчанию коэффициентом роста.
	Queue(Int32)	Инициализирует новый пустой экземпляр класса Queue с указанной начальной емкостью и 
			заданным по умолчанию коэффициентом роста.
	Queue(Int32, Single)	Инициализирует новый пустой экземпляр класса Queue с указанными начальной емкостью и 
				коэффициентом роста.


Методы
////////////////////////////////////////////
  	Имя	Описание
	Clear	Удаляет все объекты из коллекции Queue.
	Clone	Создает неполную копию коллекции Queue.
	Contains	Определяет, принадлежит ли элемент коллекции Queue.
	CopyTo	Копирует элементы коллекции Queue в существующий одномерный массив Array начиная с указанного значения индекса массива.
	Dequeue	Удаляет и возвращает объект, находящийся в начале коллекции Queue.
	Enqueue	Добавляет объект в конец коллекции Queue.
	Equals	Определяет, равен ли заданный объект Object текущему объекту Object. (Унаследовано от Object.)
	Finalize	Позволяет объекту Object попытаться освободить ресурсы и выполнить другие операции очистки, перед тем как объект Object будет утилизирован в процессе сборки мусора. (Унаследовано от Object.)
	GetEnumerator	Возвращает перечислитель, осуществляющий перебор элементов коллекции Queue.
	GetHashCode	Играет роль хэш-функции для определенного типа. (Унаследовано от Object.)
	GetType	Возвращает объект Type для текущего экземпляра. (Унаследовано от Object.)
	MemberwiseClone	Создает неполную копию текущего объекта Object. (Унаследовано от Object.)
	Peek	Возвращает объект, находящийся в начале коллекции Queue, но не удаляет его.
	Synchronized	Возвращает синхронизированную (потокобезопасную) оболочку коллекции Queue.
	ToArray	Копирует элементы коллекции Queue в новый массив.
	ToString	Возвращает объект String, который представляет текущий объект Object. (Унаследовано от Object.)
	TrimToSize	Задает значение емкости, равное действительному количеству элементов в коллекции Queue.

Свойства
///////////////////////////////////////////////////
  	Имя	Описание
	Count	Возвращает число элементов, содержащихся в коллекции Queue.
	IsSynchronized	Получает значение, позволяющее определить, является ли доступ к коллекции Queue синхронизированным (потокобезопасным).
	SyncRoot	Получает объект, который позволяет синхронизировать доступ к коллекции Queue.











