SortedList - конструктор
/////////////////////////////////////////////

Имя	Описание
	SortedList()	Инициализирует новый пустой экземпляр класса SortedList с начальной емкостью по умолчанию, упорядоченный в соответствии с интерфейсом IComparable, который реализован каждым ключом, добавленным в объект SortedList. 
	SortedList(IComparer)	Инициализирует новый пустой экземпляр класса SortedList с начальной емкостью по умолчанию, упорядоченный в соответствии с указанным интерфейсом IComparer. 
	SortedList(IDictionary)	Инициализирует новый экземпляр SortedList, содержащий элементы, скопированные из указанного словаря, обладающий начальной емкостью, равной количеству скопированных элементов и упорядоченный в соответствии с реализацией интерфейса IComparable каждого ключа. 
	SortedList(Int32)	Инициализирует новый пустой экземпляр класса SortedList с указанной начальной емкостью, упорядоченный в соответствии с интерфейсом IComparable, который реализован каждым ключом, добавленным в объект SortedList. 
	SortedList(IComparer, Int32)	Инициализирует новый пустой экземпляр класса SortedList с указанной начальной емкостью, упорядоченный в соответствии с указанным интерфейсом IComparer. 
	SortedList(IDictionary, IComparer)	Инициализирует новый экземпляр SortedList, содержащий элементы, скопированные из указанного словаря, обладающий начальной емкостью, равной количеству скопированных элементов и упорядоченный в соответствии с указанным интерфейсом IComparer.


Методы
////////////////////////////////////////////////
  	Имя	Описание
	Add	Добавляет элемент с указанными ключом и значением в объект SortedList. 
	Clear	Удаляет все элементы из объекта SortedList. 
	Clone	Создает неполную копию объекта SortedList. 
	Contains	Определяет, содержит ли объект SortedList указанный ключ. 
	ContainsKey	Определяет, содержит ли объект SortedList указанный ключ. 
	ContainsValue	Определяет, содержит ли объект SortedList указанное значение. 
	CopyTo	Копирует элементы объекта SortedList в одномерный объект Array начиная с указанного значения индекса массива. 
	Equals	Определяет, равен ли заданный объект Object текущему объекту Object. (Унаследовано от Object.)
	Finalize	Позволяет объекту Object попытаться освободить ресурсы и выполнить другие операции очистки, перед тем как объект Object будет утилизирован в процессе сборки мусора. (Унаследовано от Object.)
	GetByIndex	Получает значение с указанным индексом из объекта SortedList. 
	GetEnumerator	Возвращает объект IDictionaryEnumerator, осуществляющий перебор элементов объекта SortedList. 
	GetHashCode	Играет роль хэш-функции для определенного типа. (Унаследовано от Object.)
	GetKey	Получает ключ с указанным индексом из объекта SortedList. 
	GetKeyList	Получает ключи из объекта SortedList. 
	GetType	Возвращает объект Type для текущего экземпляра. (Унаследовано от Object.)
	GetValueList	Получает значения из объекта SortedList. 
	IndexOfKey	Возвращает индекс (с нуля) указанного ключа в объекте SortedList. 
	IndexOfValue	Индекс (с нуля) первого вхождения указанного значения в объекте SortedList. 
	MemberwiseClone	Создает неполную копию текущего объекта Object. (Унаследовано от Object.)
	Remove	Удаляет элемент с указанным ключом из объекта SortedList. 
	RemoveAt	Удаляет элемент с указанным индексом из объекта SortedList. 
	SetByIndex	Заменяет значение по указанному индексу в объекте SortedList. 
	Synchronized	Возвращает синхронизированную (потокобезопасную) оболочку объекта SortedList. 
	ToString	Возвращает объект String, который представляет текущий объект Object. (Унаследовано от Object.)
	TrimToSize	Задает значение емкости, равное действительному количеству элементов в объекте SortedList.

Свойства
///////////////////////////////////////////////////
  	Имя	Описание
	Capacity	Возвращает или задает емкость объекта SortedList. 
	Count	Получает количество элементов, содержащихся в объекте SortedList. 
	IsFixedSize	Получает значение, показывающее, имеет ли объект SortedList фиксированный размер. 
	IsReadOnly	Возвращает значение, указывающее, является ли объект SortedList доступным только для чтения. 
	IsSynchronized	Возвращает значение, указывающее на то, является ли доступ к объекту SortedList синхронизированным (потокобезопасным). 
	Item	Возвращает или задает значение, связанное с указанным ключом в объекте SortedList. 
	Keys	Получает ключи из объекта SortedList. 
	SyncRoot	Получает объект, который позволяет синхронизировать доступ к объекту SortedList. 
	Values	Получает значения из объекта SortedList.