DirectoryInfo - конструктор
/////////////////////////////////

DirectoryInfo	Выполняет инициализацию нового экземпляра класса DirectoryInfo для заданного пути.

//////////////////////////////

Методы
  	Имя	Описание
	Create	Перегружен. Создает каталог.
	CreateObjRef	Создает объект, который содержит всю необходимую информацию для создания прокси-сервера, используемого для взаимодействия с удаленным объектом. (Унаследовано от MarshalByRefObject.)
	CreateSubdirectory	Перегружен. Создает один или несколько подкаталогов по заданному пути. Путь может быть задан относительно текущего экземпляра класса DirectoryInfo.
	Delete	Перегружен. Удаляет DirectoryInfo и его содержимое из пути.
	Equals	Определяет, равен ли заданный объект Object текущему объекту Object. (Унаследовано от Object.)
	Finalize	Позволяет объекту Object попытаться освободить ресурсы и выполнить другие операции очистки, перед тем как объект Object будет утилизирован в процессе сборки мусора. (Унаследовано от Object.)
	GetAccessControl	Перегружен. Получает записи списка управления доступом для текущего каталога. 
	GetDirectories	Перегружен. Возвращает подкаталоги текущего каталога.
	GetFiles	Перегружен. Возвращает список файлов текущего каталога.
	GetFileSystemInfos	Перегружен. Извлекает массив строго типизированных объектов FileSystemInfo, представляющих файлы и подкаталоги текущего каталога.
	GetHashCode	Играет роль хэш-функции для определенного типа. (Унаследовано от Object.)
	GetLifetimeService	Извлекает объект обслуживания во время существования, который управляет политикой времени существования данного экземпляра. (Унаследовано от MarshalByRefObject.)
	GetObjectData	Устанавливает объект SerializationInfo с именем файла и дополнительными сведениями об исключении. (Унаследовано от FileSystemInfo.)
	GetType	Возвращает объект Type для текущего экземпляра. (Унаследовано от Object.)
	InitializeLifetimeService	Возвращает объект обслуживания во время существования для управления политикой времени существования данного экземпляра. (Унаследовано от MarshalByRefObject.)
	MemberwiseClone	Перегружен. 
	MoveTo	Перемещает экземпляр DirectoryInfo и его содержимое в местоположение, на которое указывает новый путь.
	Refresh	Обновляет состояние объекта. (Унаследовано от FileSystemInfo.)
	SetAccessControl	Применяет записи списка управления доступом (ACL), описанные объектом DirectorySecurity, к каталогу, который описывается текущим объектом DirectoryInfo.
	ToString	Возвращает исходный путь, переданный пользователем. (Переопределяет Object.ToString().)
//////////////////////////

Поля
  	Имя	Описание
	FullPath	Представляет полный путь к каталогу или файлу. (Унаследовано от FileSystemInfo.)
	OriginalPath	Первоначально заданный пользователем относительный или абсолютный путь. (Унаследовано от FileSystemInfo.)

///////////////////////////

Свойства
  	Имя	Описание
	Attributes	Получает или задает FileAttributes текущего FileSystemInfo. (Унаследовано от FileSystemInfo.)
	CreationTime	Получает или задает время создания текущего объекта FileSystemInfo. (Унаследовано от FileSystemInfo.)
	CreationTimeUtc	Получает или задает время создания текущего объекта FileSystemInfo в формате всеобщего скоординированного времени (UTC). (Унаследовано от FileSystemInfo.)
	Exists	Получает значение, определяющее наличие каталога. (Переопределяет FileSystemInfo.Exists.)
	Extension	Получает строку, содержащую расширение файла. (Унаследовано от FileSystemInfo.)
	FullName	Получает полный путь к каталогу или файлу. (Унаследовано от FileSystemInfo.)
	LastAccessTime	Получает или задает время последнего доступа к текущему файлу или каталогу. (Унаследовано от FileSystemInfo.)
	LastAccessTimeUtc	Получает или задает дату и время последнего доступа к заданному файлу или каталогу в формате всеобщего скоординированного времени (UTC). (Унаследовано от FileSystemInfo.)
	LastWriteTime	Получает или задает время последней операции записи в текущий файл или каталог. (Унаследовано от FileSystemInfo.)
	LastWriteTimeUtc	Получает или задает время последней операции записи в текущий файл или каталог в формате всеобщего скоординированного времени (UTC). (Унаследовано от FileSystemInfo.)
	Name	Получает имя данного экземпляра DirectoryInfo. (Переопределяет FileSystemInfo.Name.)
	Parent	Получает родительский каталог заданного подкаталога.
	Root	Получает корневой элемент пути.
